10
+--+--+--+--+--+--+--+--+--+--+
               |  |        |  |
+  +--+--+--+--+  +  +--+  +  +
|     |     |  |        |     |
+  +--+--+  +  +  +--+--+--+  +
|        |  |     |           |
+--+  +  +  +  +--+--+--+--+  +
|     |                    |  |
+  +--+--+  +  +--+  +  +  +  +
|  |        |  |  |  |  |  |  |
+--+  +  +--+--+  +  +--+--+  +
|     |  |     |  |  |     |  |
+--+  +--+--+  +  +  +--+  +--+
|     |  |     |        |     |
+  +  +  +--+  +--+  +  +  +--+
|  |  |        |  |  |  |  |  |
+  +--+  +--+--+  +  +  +  +  +
|     |              |        |
+  +--+  +--+  +--+  +  +--+  +
|     |     |     |  |  |      
+--+--+--+--+--+--+--+--+--+--+
